10 11 10 11 10 11 10 11 10 11 10 11 10 11 10 11 10 11 10 11 10 11 10 11 10 11 10 11 10 11 10 11 10 11 10 11 10 11 10 11 10 11 10 11 10 11 10 11 10 11
12 13 12 13 12 13 12 13 12 13 12 13 12 13 12 13 12 13 12 13 12 13 12 13 12 13 12 13 12 13 12 13 12 13 12 13 12 13 12 13 12 13 12 13 12 13 12 13 12 13
11 10 11 10 11 10 11 10 11 10 11 14 18 23 23 23 23 23 23 23 23 23 23 23 23 23 23 23 23 23 23 23 23 19 14 14 14 14 14 14 14 14 14 14 10 11 10 11 10 11
13 12 13 12 13 12 13 12 13 12 13 14 24 16 16 16 16 16 16 16 16 16 16 16 16 16 16 16 16 16 16 16 16 25 14 14 14 14 14 15 14 14 14 14 12 13 12 13 12 13
10 11 10 11 10 11 10 11 10 11 10 11 24 16 16 16 16 16 16 16 16 16 16 16 16 16 16 16 16 16 16 16 16 25 14 14 14 14 14 14 14 14 14 14 10 11 10 11 10 11
12 13 12 13 12 13 12 13 12 13 12 13 24 16 16 16 16 16 16 16 16 16 16 16 16 16 16 16 16 16 16 16 16 25 14 14 14 14 14 14 14 14 14 14 12 13 12 13 12 13
11 10 11 10 11 10 11 10 11 10 11 14 24 16 16 16 16 16 16 16 16 16 16 16 16 16 16 16 16 16 16 16 16 31 23 23 23 23 19 14 14 14 14 14 10 11 10 11 10 11
13 12 13 12 13 12 13 12 13 12 13 14 24 16 16 16 16 16 16 16 16 16 16 17 16 16 16 16 16 16 16 16 16 16 16 16 16 16 25 14 14 15 14 14 12 13 12 13 12 13
10 11 10 11 10 11 10 11 10 11 10 11 24 16 16 16 16 16 16 16 16 16 16 16 16 16 16 16 16 17 16 16 16 16 16 16 16 16 25 14 14 14 14 14 10 11 10 11 10 11
12 13 12 13 12 13 12 13 12 13 12 13 24 16 16 16 16 16 16 16 16 16 16 16 16 16 16 16 16 16 16 16 16 16 16 16 16 16 25 14 14 14 14 14 12 13 12 13 12 13
11 10 11 10 11 10 11 10 11 10 11 14 24 16 16 16 16 16 17 16 16 16 16 16 16 17 16 16 16 16 16 16 16 16 16 16 16 16 25 14 14 15 14 14 10 11 10 11 10 11
13 12 13 12 13 12 13 12 13 12 13 14 24 16 16 16 16 16 16 16 16 16 16 16 16 16 16 16 16 16 16 16 16 16 16 16 16 16 25 14 14 14 14 14 12 13 12 13 12 13
10 11 10 11 10 11 10 11 10 11 10 11 24 16 16 16 16 16 16 16 16 16 16 16 16 16 16 16 16 16 16 16 16 16 16 16 16 16 25 14 14 14 10 11 10 11 10 11 10 11
12 13 12 13 12 13 12 13 12 13 12 13 20 22 22 22 22 22 22 22 22 22 22 22 22 22 22 22 22 22 22 22 22 22 22 22 22 22 21 14 14 14 12 13 12 13 12 13 12 13
11 10 11 10 11 10 11 10 11 10 11 14 14 14 15 14 14 14 37 34 39 14 15 14 14 14 14 14 14 15 14 14 14 14 14 15 14 14 14 14 14 14 10 11 10 11 10 11 10 11
13 12 13 12 13 12 13 12 13 12 13 14 14 14 14 14 14 14 36 27 35 14 14 14 14 14 14 14 14 14 14 14 14 14 14 14 14 14 14 14 14 14 12 13 12 13 12 13 12 13
10 11 10 11 10 11 10 11 10 11 10 11 14 14 14 14 14 14 36 27 35 14 14 14 14 15 14 14 14 14 14 14 14 15 14 14 14 14 14 14 10 11 10 11 10 11 10 11 10 11
12 13 12 13 12 13 12 13 12 13 12 13 14 14 14 15 14 14 36 27 35 14 14 14 14 14 14 14 14 14 14 14 14 14 14 14 14 14 14 14 12 13 12 13 12 13 12 13 12 13
11 10 11 10 11 10 11 10 11 10 11 14 14 14 14 14 14 14 36 27 35 14 14 15 14 14 14 14 14 14 15 14 14 14 14 14 14 14 10 11 10 11 10 11 10 11 10 11 10 11
13 12 13 12 13 12 13 12 13 12 13 14 14 14 14 14 14 14 36 27 35 14 14 14 14 14 15 14 14 14 14 14 14 14 14 14 14 14 12 13 12 13 12 13 12 13 12 13 12 13
14 14 14 14 14 14 14 14 14 15 14 14 14 14 14 14 14 14 36 27 35 15 14 14 14 14 14 14 14 14 14 14 15 14 14 14 14 14 14 14 14 14 14 14 14 14 14 14 14 14
14 14 14 14 14 14 14 15 14 14 14 14 14 14 14 14 14 14 36 27 35 14 14 14 14 14 14 14 14 14 14 14 14 14 14 14 14 14 14 14 14 14 14 14 14 14 14 14 14 14
14 14 14 14 14 14 14 14 14 14 14 14 14 37 34 34 34 34 43 27 41 34 34 34 34 34 34 34 34 34 34 34 34 34 34 34 34 34 34 39 14 14 14 14 14 14 14 14 14 14
14 14 14 14 14 14 14 14 14 14 14 14 14 36 27 27 27 27 27 27 27 27 27 27 27 27 27 27 27 27 27 27 27 27 27 27 27 27 27 35 14 14 14 14 14 14 14 14 14 14
14 14 14 14 15 14 14 14 14 14 14 14 14 40 33 33 33 33 42 27 44 33 33 33 33 33 33 33 33 33 33 33 33 33 33 33 33 33 33 38 14 14 14 14 14 14 14 14 14 14
14 14 14 14 14 14 14 14 14 14 14 14 14 14 14 14 14 14 36 27 35 14 14 14 14 14 14 14 14 14 14 14 14 14 14 14 14 14 14 14 14 14 14 14 14 14 14 14 15 14
14 14 14 14 14 14 14 15 14 14 14 14 14 15 14 14 14 14 36 27 35 14 14 14 15 14 14 14 14 14 14 14 14 14 14 14 14 14 14 14 14 14 14 14 14 14 14 14 14 14
15 14 14 14 14 14 14 14 14 14 14 14 14 14 14 14 15 14 36 27 35 14 14 14 14 14 14 14 14 14 14 14 14 14 14 14 15 14 14 14 14 14 14 14 14 14 14 14 14 14
14 14 14 14 14 14 14 14 14 14 14 14 14 14 14 14 14 14 36 27 35 14 14 14 14 14 14 14 14 15 14 14 14 14 14 14 14 14 14 14 14 15 14 14 14 14 14 14 14 14
14 14 14 14 14 15 14 14 14 14 15 14 14 14 14 14 14 14 36 27 35 14 14 14 15 14 14 14 14 14 14 14 14 15 14 14 14 15 14 14 14 14 14 14 15 14 14 14 14 14
14 14 14 14 14 14 14 14 14 14 14 14 14 14 14 14 14 14 36 27 35 14 14 14 14 14 14 14 14 14 14 14 14 14 14 14 14 14 14 14 14 14 14 14 14 14 14 14 14 15
14 15 14 14 14 14 14 14 14 14 14 14 14 14 14 14 14 14 36 27 35 14 14 14 14 14 14 14 14 14 14 14 14 14 14 14 14 14 14 14 14 14 14 14 14 14 14 14 14 14
14 14 14 14 14 14 14 14 14 14 14 14 14 14 14 14 14 14 40 33 38 14 15 14 14 14 14 14 14 14 14 14 14 14 14 14 14 14 14 14 14 14 14 14 14 14 14 14 14 14
14 14 15 14 14 14 14 14 14 28 28 28 28 28 28 28 28 28 28 26 28 28 28 28 28 28 28 28 28 28 28 28 28 28 14 14 14 14 14 14 14 14 14 15 14 14 14 14 14 14
14 14 14 14 14 14 14 14 14 28 26 26 26 26 26 26 26 26 26 26 26 26 26 26 26 26 26 26 26 26 26 26 26 28 14 14 14 15 14 14 14 14 14 14 14 14 14 14 14 14
14 14 14 14 14 15 14 14 14 28 26 26 26 26 26 26 26 26 26 26 26 26 26 26 26 26 26 26 26 26 26 26 26 28 14 14 14 14 14 14 14 14 14 14 14 15 14 14 14 14
14 14 14 14 14 14 14 14 14 28 26 26 26 26 26 26 26 26 26 26 26 26 26 26 26 26 26 26 26 26 26 26 26 28 28 28 14 14 14 14 14 14 14 14 14 14 14 14 14 14
14 15 14 14 14 14 14 14 14 28 26 26 26 26 26 26 26 26 26 26 26 26 26 26 26 26 26 26 26 26 26 26 26 26 26 28 28 28 28 28 28 28 28 28 28 28 28 14 14 14
14 14 14 28 28 28 28 28 28 28 26 26 26 26 26 26 26 26 26 26 26 26 26 26 26 26 26 26 26 26 26 26 26 26 26 26 26 26 26 26 26 26 26 26 26 26 28 14 14 14
14 14 14 28 26 26 26 26 26 26 26 26 26 26 26 26 26 26 26 26 26 26 26 26 26 26 26 26 26 26 26 26 26 26 26 26 26 26 26 26 26 26 26 26 26 26 28 14 15 14
14 14 14 28 26 26 26 26 26 26 26 26 26 26 26 26 26 26 26 26 26 26 26 26 26 26 26 26 26 26 26 26 26 26 26 26 26 26 26 26 26 26 26 26 26 26 28 14 14 14
28 28 28 28 26 26 26 26 26 26 26 26 26 26 26 26 26 26 26 26 26 26 26 26 26 26 26 26 26 26 26 26 26 26 26 26 26 26 26 26 26 26 26 26 26 26 28 28 28 28
28 26 26 26 26 26 26 26 26 26 26 26 26 26 26 26 26 26 26 26 26 26 26 26 26 26 26 26 26 26 26 26 26 26 26 26 26 26 26 26 26 26 26 26 26 26 26 26 26 28
28 26 26 26 26 26 26 26 26 26 26 26 26 26 26 26 26 26 26 26 26 26 26 26 26 26 26 26 26 26 26 26 26 26 26 26 26 26 26 26 26 26 26 26 26 26 26 26 26 28
28 26 26 26 26 26 26 26 26 26 26 26 26 26 26 26 26 26 26 26 26 26 26 26 26 26 26 26 26 26 26 26 26 26 26 26 26 26 26 26 26 26 26 26 26 26 26 26 26 28 
28 26 26 26 26 26 26 26 26 26 26 26 26 26 26 26 26 26 26 26 26 26 26 26 26 26 26 26 26 26 26 26 26 26 26 26 26 26 26 26 26 26 26 26 26 26 26 26 26 28
28 26 26 26 26 26 26 26 26 26 26 26 26 26 26 26 26 26 26 26 26 26 26 26 26 26 26 26 26 26 26 26 26 26 26 26 26 26 26 26 26 26 26 26 26 26 26 26 26 28
28 26 26 26 26 26 26 26 26 26 26 26 26 26 26 26 26 26 26 26 26 26 26 26 26 26 26 26 26 26 26 26 26 26 26 26 26 26 26 26 26 26 26 26 26 26 26 26 26 28
28 26 26 26 26 26 26 26 26 26 26 26 26 26 26 26 26 26 26 26 26 26 26 26 26 26 26 26 26 26 26 26 26 26 26 26 26 26 26 26 26 26 26 26 26 26 26 26 26 28
28 28 28 28 28 28 28 28 28 28 28 28 28 28 28 28 28 28 28 28 28 28 28 28 28 28 28 28 28 28 28 28 28 28 28 28 28 28 28 28 28 28 28 28 28 28 28 28 28 28